/wiki/session-hijacking	Session Hijacking
/wiki/network-neutrality	Network Neutrality
/wiki/photobucket	Photobucket
/wiki/love-our-children-usa	Love Our Children USA
/wiki/texting	Texting
/wiki/facebook-effect	The Facebook Effect
/wiki/nook	Nook
/wiki/onguard-online	OnGuard Online
/wiki/cake-wrecks	Cake Wrecks
/wiki/leprechaun-sighting	Leprechaun Sighting
/wiki/eset-cybersecurity-mac	ESET Cybersecurity for Mac
/wiki/online-predators	Online Predators
/wiki/avira-antivir-personal	Avira Antivir Personal
/wiki/soungle-sound-effects-database	Soungle - The Sound Effects Database
/wiki/list-words-banished-queens-english-mis-use-over-use-and-general-uselessness	List of Words Banished from the Queen's English for Mis-Use, Over-Use and General Uselessness
/wiki/how-disable-javascript-safari	How to Disable JavaScript in Safari
/wiki/operation-anti-security	Operation Anti-Security
/wiki/nintendo-video	Nintendo Video
/wiki/pocket	Pocket
/wiki/maya-miguel	Maya & Miguel
/wiki/blekko	Blekko
/wiki/tobuscus	Tobuscus
/wiki/bioshock-infinite-game-guide	Bioshock Infinite Game Guide
/wiki/meg-whitman	Meg Whitman
/wiki/pirate-bay	The Pirate Bay
/wiki/armor-games	Armor Games
/wiki/internet-safety-101	Internet Safety 101
/wiki/voices-virtue	Voices For Virtue
/wiki/happy-tree-friends	Happy Tree Friends
/wiki/email-etiquette	Email Etiquette
/wiki/morality-media	Morality In Media
/wiki/quietube	Quietube
/wiki/isketch	ISketch
/wiki/zabasearch	Zabasearch
/wiki/parentalcontrolbarorg	Parentalcontrolbar.org
/wiki/awkwardworkplacephotoscom	Awkwardworkplacephotos.com
/wiki/wildtangent	WildTangent
/wiki/david-burt	David Burt
/wiki/aim	AIM
/wiki/demons-souls-game-guide	Demon's Souls Game Guide
/wiki/kidsafemailcom	KidSafeMail.com
/wiki/crunchyrollcom	Crunchyroll.com
/wiki/desktop	Desktop
/wiki/mafia-wars	Mafia Wars
/wiki/adcouncilorg	Adcouncil.org
/wiki/suite-101	Suite 101
/wiki/avg-anti-virus	AVG Anti-Virus
/wiki/nintendo-3ds	Nintendo 3DS
/wiki/deadjournal	DeadJournal
/wiki/allods-online	Allods Online
/wiki/mahalo	Mahalo
/wiki/dailybooth	DailyBooth
/wiki/wiredsafety	WiredSafety
/wiki/netaddictioncom	Netaddiction.com
/wiki/sexting	Sexting
/wiki/blogster	Blogster
/wiki/computer-entertainment-rating-organization	Computer Entertainment Rating Organization
/wiki/how-create-facebook-group	How to Create a Facebook Group
/wiki/whisper	Whisper
/wiki/nigeria419-scams	Nigeria/419 Scams
/wiki/dealnews	Dealnews
/wiki/browser-history	Browser History
/wiki/xkcd	Xkcd
/wiki/omegle	Omegle
/wiki/habbo	Habbo
/wiki/couplesspark	CouplesSpark
/wiki/eset-smart-security-4	ESET Smart Security 4
/wiki/facebook-hoaxes-scams-and-malware	Facebook Hoaxes, Scams, and Malware
/wiki/truveo	Truveo
/wiki/vuze	Vuze
/wiki/fail-blog	FAIL Blog
/wiki/pandora-one	Pandora One
/wiki/n4gcom	N4G.com
/wiki/theres-app	There's an App For That
/wiki/faceparty	Faceparty
/wiki/how-check-cookies-chrome	How to Check Cookies in Chrome
/wiki/internet-relay-chat-irc	Internet Relay Chat (IRC)
/wiki/epicorg	Epic.org
/wiki/matchmakercom	Matchmaker.com
/wiki/migente	MiGente
/wiki/safetyweb	SafetyWeb
/wiki/center-media-literacy	Center for Media Literacy
/wiki/avast	Avast
/wiki/australian-classification-board	Australian Classification Board
/wiki/grooveshark	Grooveshark
/wiki/recognizing-bashboards	Recognizing "Bashboards"
/wiki/social-network-games	Social Network Games
/wiki/botnet	Botnet
/wiki/super-crate-box	Super Crate Box
/wiki/att	AT&T
/wiki/fanfiction	Fanfiction
/wiki/teachparentstechorg	Teachparentstech.org
/wiki/pottermore	Pottermore
/wiki/cloud-parenting	Cloud Parenting
/wiki/ashampoo-magical-security-2	Ashampoo Magical Security 2
/wiki/mcgruff-safeguard	McGruff SafeGuard
/wiki/gangnam-style	Gangnam Style
/wiki/monitoring-software	Monitoring Software
/wiki/collegehumor	CollegeHumor
/wiki/educational-organizations	Educational Organizations
/wiki/xbox	Xbox
/wiki/arthur	Arthur
/wiki/lets-play	Let's Play
/wiki/screen-name	Screen name
/wiki/facial-recognition	Facial Recognition
/wiki/netspark	NetSpark
/wiki/efforg	EFF.org
/wiki/bram-cohen	Bram Cohen
/wiki/awkwardfamilyphotoscom	AwkwardFamilyPhotos.com
/wiki/k-mail	K-Mail
/wiki/personal-information-collection	Personal Information Collection
/wiki/family-education	Family Education
/wiki/defender-ministries	Defender Ministries
/wiki/forums	Forums
/wiki/parentsedge	ParentsEdge
/wiki/mama-mirabelle	Mama Mirabelle
/wiki/working-halt-online-abuse-kids-teens-division	Working to Halt Online Abuse Kids-Teens Division
/wiki/facebook-privacy-and-copyright-rights	Facebook Privacy and Copyright Rights
/wiki/net-nanny-mac	Net Nanny for Mac
/wiki/signs-cyberbullying	Signs of cyberbullying
/wiki/avira	Avira
/wiki/cyberpatrol-online-protection	CyberPatrol Online Protection
/wiki/windows-phone	Windows Phone
/wiki/monitors	Monitors
/wiki/how-check-cookies-internet-explorer	How to Check Cookies in Internet Explorer
/wiki/roms	ROMs
/wiki/webcasts	Webcasts
/wiki/bitdefender-mobile-security	BitDefender Mobile Security
/wiki/tor	Tor
/wiki/soundboard	Soundboard
/wiki/danbooru	Danbooru
/wiki/pandora-radio	Pandora Radio
/wiki/meetup	Meetup
/wiki/ipod-touch	IPod Touch
/wiki/bastion	Bastion
/wiki/google-chrome	Google Chrome
/wiki/norton-antivirus-dual-protection-mac	Norton AntiVirus Dual Protection for Mac
/wiki/internet-explorer	Internet Explorer
/wiki/esports	Esports
/wiki/gamezone	GameZone
/wiki/amazon-student	Amazon Student
/wiki/itunes	ITunes
/wiki/internet-archives	Internet archives
/wiki/starcraft-ii	Starcraft II
/wiki/moba	MOBA
/wiki/foodspotting	Foodspotting
/wiki/norton-family-resource-center	Norton Family Resource Center
/wiki/windows-7-backup	Windows 7 Backup
/wiki/peasants-quest	Peasant's Quest
/wiki/gameplay	Gameplay
/wiki/i-am-bored	I Am Bored
/wiki/creepypasta	Creepypasta
/wiki/emule	EMule
/wiki/windows-registry	Windows Registry
/wiki/demand-media	Demand Media
/wiki/hyperbole-and-half	Hyperbole and a Half
/wiki/pbs-kids	PBS Kids
/wiki/myedge	MyEdge
/wiki/how-create-google-doc	How to Create a Google Doc
/wiki/how-create-use-phone-contract	How to create a "use of phone" contract.
/wiki/panda-global-protection-2011	Panda Global Protection 2011
/wiki/left-4-dead-series	Left 4 Dead Series
/wiki/askcom	Ask.com
/wiki/facebookforparentsorg	Facebookforparents.org
/wiki/charlie-unicorn	Charlie the Unicorn
/wiki/router	Router
/wiki/tyler-clementi	Tyler Clementi
/wiki/bitdefender-gamesafe	BitDefender GameSafe
/wiki/browser	Browser
/wiki/jibjab	JibJab
/wiki/tagged	Tagged
/wiki/phonebeagle	PhoneBeagle
/wiki/gogoyoko	Gogoyoko
/wiki/learn-program	Learn to Program
/wiki/filterpak	FilterPak
/wiki/top-level-domain	Top-level Domain
/wiki/cooliris	Cooliris
/wiki/spelunky	Spelunky
/wiki/wifi	Wifi
/wiki/bypassing-safety-knowledge-power	Bypassing Safety (Knowledge is Power)
/wiki/levelator	Levelator
/wiki/craig-newmark	Craig Newmark
/wiki/penny-arcade	Penny Arcade
/wiki/verizon-parental-control-center	Verizon Parental Control Center
/wiki/hotpot	Hotpot
/wiki/usernames	Usernames
/wiki/how-disable-javascript-google-chrome	How to Disable JavaScript in Google Chrome
/wiki/ibm	IBM
/wiki/isafe	ISafe
/wiki/online-family	Online Family
/wiki/marcel-shell	Marcel the Shell
/wiki/megatokyo	Megatokyo
/wiki/fark	FARK
/wiki/cybermentors	CyberMentors
/wiki/mcafee	McAfee
/wiki/pearltrees	Pearltrees
/wiki/tiny-wings	Tiny Wings
/wiki/safekids	SafeKids
/wiki/linux-distribution	Linux Distribution
/wiki/graphical-passwords	Graphical Passwords
/wiki/grape-lady-falls	Grape Lady Falls!
/wiki/brightkite	Brightkite
/wiki/windows-live-essentials	Windows Live Essentials
/wiki/2shared	2shared
/wiki/ashampoo-firewall-pro	Ashampoo Firewall PRO
/wiki/internet-fraud	Internet Fraud
/wiki/parental-controls-windows-xp	Parental Controls for Windows XP
/wiki/get-game-smart	Get Game Smart
/wiki/vsauce	Vsauce
/wiki/textfree	Textfree
/wiki/plagiarism	Plagiarism
/wiki/youthgamblingcom	Youthgambling.com
/wiki/how-file-complaint-xbox-live	How to File a Complaint on Xbox LIVE
/wiki/parental-controls-windows-phone	Parental Controls for Windows Phone
/wiki/ted-talks	TED Talks
/wiki/draw-something	Draw Something
/wiki/pc-tools-internet-security	PC Tools Internet Security
/wiki/mamma	Mamma
/wiki/fmylife	FMyLife
/wiki/common-acronym-list	Common Acronym List
/wiki/wikileaks	WikiLeaks
/wiki/reply	@Reply
/wiki/pitchfork	Pitchfork
/wiki/flame-wars	Flame Wars
/wiki/security-essentials	Security Essentials
/wiki/onion	The Onion
/wiki/shutterfly	Shutterfly
/wiki/spyware-removal-software	Spyware Removal Software
/wiki/rzonz	Rzonz
/wiki/acai	Acai
/wiki/inobtr	INOBTR
/wiki/linux	Linux
/wiki/general-security-and-safety-guidelines	General Security and Safety Guidelines
/wiki/cramster	Cramster
/wiki/ripping	Ripping
/wiki/rss	RSS
/wiki/hacker	Hacker
/wiki/facetime	FaceTime
/wiki/adblock-plus	Adblock Plus
/wiki/land-your-land	This Land is Your Land
/wiki/boolean-operators	Boolean Operators
/wiki/associated-content	Associated Content
/wiki/dictionary-attack	Dictionary Attack
/wiki/internet-security-complete	Internet Security Complete
/wiki/boston-public-schools-internet-safety-blog	Boston Public Schools Internet Safety Blog
/wiki/vishing	Vishing
/wiki/maxprotect	MaxProtect
/wiki/typepad	TypePad
/wiki/html	Html
/wiki/google-plus	Google Plus
/wiki/parental-controls-iphone-ipod-touch-and-ipad	Parental Controls for iPhone, iPod touch, and iPad
/wiki/jane-lynch	Jane Lynch
/wiki/nadia-kajouji	Nadia Kajouji
/wiki/breakcom	Break.com
/wiki/micropayment	Micropayment
/wiki/badger-badger-badger	Badger Badger Badger
/wiki/dr-horribles-sing-along-blog	Dr. Horrible's Sing-Along Blog
/wiki/chatmagcom	chatmag.com
/wiki/napster	Napster
/wiki/fileplanetcom	FilePlanet.com
/wiki/dpreviewcom	DPReview.com
/wiki/apple%E2%80%99s-app-rating-system	Apple’s App Rating System
/wiki/gowalla	Gowalla
/wiki/jane-austens-fight-club	Jane Austen's Fight Club
/wiki/aol	AOL
/wiki/steam	Steam
/wiki/safe-eyes	Safe Eyes
/wiki/woogiworld	WoogiWorld
/wiki/path	Path
/wiki/7wonderliciouscom	7wonderlicious.com
/wiki/organizations-kids	Organizations for Kids
/wiki/profile-social-networking-online-dating-sites	Profile (social networking, online dating sites)
/wiki/panda-internet-security-2011	Panda Internet Security 2011
/wiki/camstudioorg	Camstudio.org
/wiki/instant-messaging	Instant Messaging
/wiki/url	URL
/wiki/chocolate-rain	Chocolate Rain
/wiki/secure-email	Secure Email
/wiki/firesheep	Firesheep
/wiki/hearthstone	Hearthstone
/wiki/tinyurl	TinyUrl
/wiki/blacklisting	Blacklisting
/wiki/parental-controls-software	Parental Controls Software
/wiki/google-doc	Google Doc
/wiki/xxx	.XXX
/wiki/internet-cache	Internet Cache
/wiki/pc-mag	PC Mag
/wiki/conficker	Conficker
/wiki/cracked	Cracked
/wiki/hi5	Hi5
/wiki/forwards	Forwards
/wiki/bitbop	Bitbop
/wiki/ram	Ram
/wiki/crackle	Crackle
/wiki/how-block-or-remove-pages-and-images-using-robotstxt-file	How to block or remove pages and images using a robots.txt file
/wiki/patch	Patch
/wiki/starwarscom	StarWars.com
/wiki/apk	APK
/wiki/mashable	Mashable
/wiki/skype	Skype
/wiki/thinspiration	Thinspiration
/wiki/please-rob-me	Please Rob Me
/wiki/wiki-articles	Wiki Articles
/wiki/obsidian-portal	Obsidian Portal
/wiki/frenemy	Frenemy
/wiki/content-filters	Content Filters
/wiki/ask-marian	Ask Marian
/wiki/whyville	Whyville
/wiki/pics-dont-suck	Pics That Don't Suck
/wiki/seriously-so-blessed	Seriously, So Blessed!
/wiki/getnetwise	GetNetWise
/wiki/deviantart	Deviantart
/wiki/wolframalphacom	Wolframalpha.com
/wiki/evow	EVow
/wiki/pop3	POP3
/wiki/woot	Woot!
/wiki/miniclip	Miniclip
/wiki/my-little-pony	My Little Pony
/wiki/potter-puppet-pals-content-guide	Potter Puppet Pals Content Guide
/wiki/comodo-internet-security	Comodo Internet Security
/wiki/rifftrax	Rifftrax
/wiki/how-sync-web-browser-bookmarks-xmarks	How to Sync Web Browser Bookmarks With Xmarks
/wiki/kindle-fire	Kindle Fire
/wiki/xss-reflected-attack	XSS - Reflected Attack
/wiki/netsmartz411	NetSmartz411
/wiki/netscape	Netscape
/wiki/ziddu	Ziddu
/wiki/getting-started	Getting Started
/wiki/joystiq	Joystiq
/wiki/google-buzz	Google Buzz
/wiki/matchmateme	MatchMate.Me
/wiki/leave-britney-alone	Leave Britney Alone
/wiki/executable-email-attachments	Executable email attachments
/wiki/nsteens	NSTeens
/wiki/wordsmyth	WordSmyth
/wiki/how-create-redirects	How to Create Redirects
/wiki/avira-premium-security	Avira Premium Security
/wiki/wikihow	WikiHow
/wiki/kids-corner-windows-phone	Kid's Corner (Windows Phone)
/wiki/bitwiki	BitWiki
/wiki/cyberpatrol-parental-controls	CyberPatrol Parental Controls
/wiki/avast-free-antivirus	Avast! Free Antivirus
/wiki/ytmnd	YTMND
/wiki/ryze	Ryze
/wiki/tmobile	TMobile
/wiki/contributors	Contributors
/wiki/add-ons	Add-ons
/wiki/ebaums-world	Ebaum's World
/wiki/vine	Vine
/wiki/groupon	Groupon
/wiki/learnthenetcom	Learnthenet.com
/wiki/servers	Servers
/wiki/ssl	SSL
/wiki/ssh	SSH
/wiki/vidme	VidMe
/wiki/trending-topics	Trending Topics
/wiki/amazon-web-services	Amazon Web Services
/wiki/ccleaner	Ccleaner
/wiki/massively-multiplayer-online-game-safety	Massively Multiplayer Online Game Safety
/wiki/chegg	Chegg
/wiki/sms-spam	SMS Spam
/wiki/pc-tools	PC Tools
/wiki/atomcom	Atom.com
/wiki/how-use-youtubes-safe-mode	How to Use YouTube's Safe Mode
/wiki/http	HTTP
/wiki/books-about-internet-dating	Books About Internet Dating
/wiki/imageboard	Imageboard
/wiki/trend-micro-mobile-security-android	Trend Micro Mobile Security for Android
/wiki/mobile-devices-phones-and-tablets	Mobile Devices - Phones and Tablets
/wiki/setting-opendns-linksys-wrt54g-router	Setting up OpenDNS - Linksys WRT54G Router
/wiki/toptenreviewscom	Toptenreviews.com
/wiki/outpost-firewall-free	Outpost Firewall FREE
/wiki/iwastesomuchtimecom	Iwastesomuchtime.com
/wiki/scroogle	Scroogle
/wiki/proboards	Proboards
/wiki/kaspersky	Kaspersky
/wiki/sftp	SFTP
/wiki/identity-theft-resource-center	Identity Theft Resource Center
/wiki/filtering-software	Filtering Software
/wiki/stop-online-piracy-act-sopa	Stop Online Piracy Act (SOPA)
/wiki/enough-enough	Enough is Enough
/wiki/doxing	Doxing
/wiki/jayne-hitchcock	Jayne Hitchcock
/wiki/common-sense-media	Common Sense Media
/wiki/ideas-new-articles	Ideas for New Articles
/wiki/cell-phones	Cell Phones
/wiki/malwarebytes-anti-malware	Malwarebytes Anti-Malware
/wiki/guy-walks-across-america	Guy Walks Across America
/wiki/spartz-network	The Spartz Network
/wiki/companies	Companies
/wiki/gogostat	GoGoStat
/wiki/farmville	FarmVille
/wiki/k9-web-protection	K9 Web Protection
/wiki/easter-eggs	Easter Eggs
/wiki/penny-auctions	Penny Auctions
/wiki/martha-speaks	Martha Speaks
/wiki/fccgov	FCC.gov
/wiki/how-disable-pop-ups-firefox	How to Disable Pop-Ups in Firefox
/wiki/super-why	Super Why!
/wiki/myspace	MySpace
/wiki/webmd	WebMD
/wiki/activex	ActiveX
/wiki/golden-filter-pro	Golden Filter Pro
/wiki/big-brother-keylogger	Big Brother Keylogger
/wiki/x3-watch	X3 Watch
/wiki/technorati	Technorati
/wiki/setting-opendns-apple-router	Setting up OpenDNS - Apple Router
/wiki/mabinogi	Mabinogi
/wiki/jessicas-daily-affirmation	Jessica's Daily Affirmation
/wiki/brawl-family	Brawl in the Family
/wiki/netfamilynews	NetFamilyNews
/wiki/kidskonnect	KidsKonnect
/wiki/how-create-linkedin-account	How to Create a LinkedIn Account
/wiki/malware	Malware
/wiki/cyber-sentinel	Cyber Sentinel
/wiki/perfectmatch	PerfectMatch
/wiki/fraudorg	Fraud.org
/wiki/miss-teen-usa-south-carolina	Miss Teen USA South Carolina
/wiki/strong-bad-emails	Strong Bad Emails
/wiki/jessi-slaughter	Jessi Slaughter
/wiki/wimp	Wimp
/wiki/how-remove-unsafe-chrome-extensions	How to Remove Unsafe Chrome Extensions
/wiki/perfect-world	Perfect World
/wiki/gabcast	Gabcast
/wiki/angelfire	Angelfire
/wiki/citizens-community-values	Citizens for Community Values
/wiki/stupidvideos	Stupidvideos
/wiki/impact	IMPACT
/wiki/mozy	Mozy
/wiki/what-encryption	What is Encryption?
/wiki/cleverbot	Cleverbot
/wiki/electronic-mailing-list	Electronic Mailing List
/wiki/how-create-citation	How to Create a Citation
/wiki/stardoll	Stardoll
/wiki/swipely	Swipely
/wiki/10-ways-protect-your-identity-online	10 Ways to Protect Your Identity Online
/wiki/norton-online-backup	Norton Online Backup
/wiki/pornography-filtering-and-monitoring-software	Pornography Filtering and Monitoring Software
/wiki/norton-internet-security-mac	Norton Internet Security for Mac
/wiki/wwwantiphishingorg	www.antiphishing.org
/wiki/jenna-marbles	Jenna Marbles
/wiki/llamas-hats	Llamas with Hats
/wiki/easybib	EasyBib
/wiki/how-block-images-chrome	How to Block Images in Chrome
/wiki/comodo	Comodo
/wiki/moms-media	Moms on Media
/wiki/surfbuddiescom	SurfBuddies.com
/wiki/bloxx	Bloxx
/wiki/heavycom	Heavy.com
/wiki/pencilkids	Pencilkids
/wiki/netsmartz-kids	NetSmartz Kids
/wiki/mintcom	Mint.com
/wiki/netbook	Netbook
/wiki/atlantica-online	Atlantica Online
/wiki/droidsecurity	DroidSecurity
/wiki/screenit	ScreenIt
/wiki/minecraft	Minecraft
/wiki/nethack	Nethack
/wiki/spokeo-phonebook-knows-too-much	Spokeo - The Phonebook that Knows Too Much
/wiki/mugglenet	MuggleNet
/wiki/how-get-google-voice-number	How to Get a Google Voice Number
/wiki/google-0	Google
/wiki/gawker	Gawker
/wiki/centerd	Center'd
/wiki/youtube	YouTube
/wiki/viral-marketing	Viral marketing
/wiki/barracuda-networks	Barracuda Networks
/wiki/how-configure-parental-controls-kindle-fire	How to Configure Parental Controls on a Kindle Fire
/wiki/it-real-how-tell-if-website-scam	Is it real? How to tell if a website is a scam
/wiki/protectkidscom	ProtectKids.com
/wiki/fakechecks	FakeChecks
/wiki/augmented-reality	Augmented Reality
/wiki/panda-security	Panda Security
/wiki/biznik	Biznik
/wiki/vtunnelcom	vtunnel.com
/wiki/how-download-firefox	How to Download Firefox
/wiki/fightthenewdrugorg	Fightthenewdrug.org
/wiki/mp3-player	MP3 Player
/wiki/lfmf	LFMF
/wiki/pirated-software	Pirated software
/wiki/weemee	WeeMee
/wiki/flash	Flash
/wiki/khan-academy	Khan Academy
/wiki/detection-software	Detection Software
/wiki/safeteenscom	SafeTeens.com
/wiki/freesound	Freesound
/wiki/rottentomatoescom	RottenTomatoes.com
/wiki/vimeo	Vimeo
/wiki/word-central	Word Central
/wiki/pornography-addiction	Pornography Addiction
/wiki/stagevucom	Stagevu.com
/wiki/rockmelt	RockMelt
/wiki/quora	Quora
/wiki/rhymezone	RhymeZone
/wiki/bitdefender-antivirus-mac-and-pc	BitDefender Antivirus for Mac and PC
/wiki/effect-violence-video-games	The Effect Of Violence in Video Games
/wiki/smishing	Smishing
/wiki/photon-web-browser	Photon Web Browser
/wiki/comodo-firewall	Comodo Firewall
/wiki/sweety-high	SWEETY HIGH
/wiki/tunak-tunak-tun	Tunak Tunak Tun
/wiki/remote-administration-tool-rat	Remote Administration Tool (RAT)
/wiki/be-web-aware	Be Web Aware
/wiki/parental-controls-mac-os-x	Parental Controls for Mac OS X
/wiki/care2	Care2
/wiki/how-set-myspace-account	How to Set up a MySpace Account
/wiki/avatars	Avatars
/wiki/craigslist-killer	Craigslist Killer
/wiki/parental-controls-windows-8	Parental Controls for Windows 8
/wiki/domain-name-system	Domain Name System
/wiki/gocomics	GoComics
/wiki/wartune	Wartune
/wiki/where	WHERE
/wiki/parental-controls-windows-7	Parental Controls for Windows 7
/wiki/guild-raid	Guild Raid
/wiki/blue-coat	Blue Coat
/wiki/chillola	Chillola
/wiki/international-centre-missing-and-exploited-children	International Centre for Missing and Exploited Children
/wiki/how-passwords-are-stored	How Passwords Are Stored
/wiki/familywebwatch	FamilyWebWatch
/wiki/nintendo-wii	Nintendo Wii
/wiki/ransomware	Ransomware
/wiki/pogocom	Pogo.com
/wiki/how-disable-javascript-internet-explorer	How to Disable Javascript in Internet Explorer
/wiki/software-mobile-phones	Software for Mobile Phones
/wiki/focus-family	Focus on the Family
/wiki/cyberpatrol	CyberPatrol
/wiki/nsfw	NSFW
/wiki/wisegeek	wiseGEEK
/wiki/software-bug	Software Bug
/wiki/foxfilter	FoxFilter
/wiki/gmail	Gmail
/wiki/cricket-wireless	Cricket Wireless
/wiki/charlie-bit-my-finger	Charlie Bit My Finger
/wiki/norton-internet-security	Norton Internet Security
/wiki/katy-perry	Katy Perry
/wiki/ikee-worm	Ikee Worm
/wiki/internet	Internet
/wiki/microsoft-safety-and-security-center	Microsoft Safety and Security Center
/wiki/numberphile	Numberphile
/wiki/recoverydate	RecoveryDate
/wiki/mass-effect	Mass Effect
/wiki/cyber-angels	Cyber Angels
/wiki/esrb	ESRB
/wiki/video-game-emulators	Video Game Emulators
/wiki/editing-guidlines	Editing Guidlines
/wiki/bsecure-internet-filter-61	BSecure Internet Filter 6.1
/wiki/dealing-pop-ups	Dealing with Pop-ups
/wiki/fraudwatchinternationalcom	Fraudwatchinternational.com
/wiki/neweggcom	newegg.com
/wiki/pay-win	Pay To Win
/wiki/my-new-life	My New Life
/wiki/animabilis-software	Animabilis Software
/wiki/w3schools	W3schools
/wiki/player-vs-player	Player vs Player
/wiki/humblebundlecom	HumbleBundle.com
/wiki/flipboard	Flipboard
/wiki/how-examine-security-certificates-firefox	How to Examine Security Certificates in Firefox
/wiki/money-making-scam	Money Making Scam
/wiki/honestlycom	Honestly.com
/wiki/digg	Digg
/wiki/youdiligence	YouDiligence
/wiki/kidssurfingsafecom	Kidssurfingsafe.com
/wiki/kid-safe-mail	Kid Safe Mail
/wiki/iwipe	iWipe
/wiki/caillou	Caillou
/wiki/video-chat	video chat
/wiki/bebo	Bebo
/wiki/certificate-authority	Certificate Authority
/wiki/birthornotcom	Birthornot.com
/wiki/cybercrime101com	cybercrime101.com
/wiki/gametrailers	GameTrailers
/wiki/video-game-content-directory	Video Game Content Directory
/wiki/read-it-later	Read It Later
/wiki/maple-story	Maple Story
/wiki/ian-usher	Ian Usher
/wiki/brony	Brony
/wiki/googleorg	Google.org
/wiki/yugioh-abridged-series	Yugioh: The Abridged Series
/wiki/raywilliamjohnson	RayWilliamJohnson
/wiki/deep-freeze	Deep Freeze
/wiki/fishville	Fishville
/wiki/psn	PSN
/wiki/formspringme	Formspring.me
/wiki/window-washer	Window Washer
/wiki/windows-xp	Windows XP
/wiki/blogcriticsorg	Blogcritics.org
/wiki/lolcats	Lolcats
/wiki/department-justice-rating-titles-and-qualification-dejus	Department of Justice, Rating, Titles and Qualification (DEJUS)
/wiki/secondlife	SecondLife
/wiki/outpost-security-suite-pro	Outpost Security Suite PRO
/wiki/ezpzemail	EZpZemail
/wiki/norad-santa-tracker	Norad Santa Tracker
/wiki/fictionpress	Fictionpress
/wiki/mog	MOG
/wiki/sneezing-baby-panda	The Sneezing Baby Panda
/wiki/spotify	Spotify
/wiki/christian-music-trade-association	Christian Music Trade Association
/wiki/here-it-goes-again	Here it Goes Again
/wiki/how-disable-javascript-firefox	How to Disable JavaScript in Firefox
/wiki/windows-8-backup	Windows 8 Backup
/wiki/video-game-addictionorg	video-game-addiction.org
/wiki/tmz	TMZ
/wiki/griefing	Griefing
/wiki/free-realms	Free Realms
/wiki/yahoo	Yahoo!
/wiki/about-bullying	about Bullying
/wiki/how-disable-pop-ups-opera	How to Disable Pop Ups in Opera
/wiki/not-safe-work	Not Safe For Work
/wiki/fatcow-mail	Fatcow Mail
/wiki/ign	IGN
/wiki/remember-your-password	Remember Your Password?
/wiki/working-halt-online-abuse	Working to Halt Online Abuse
/wiki/pornaddictioninfocom	Pornaddictioninfo.com
/wiki/lookout	Lookout
/wiki/how-block-pop-ups-firefox	How to Block Pop Ups in Firefox
/wiki/cybersquatting	Cybersquatting
/wiki/carrot2	Carrot2
/wiki/buffer-overflow	Buffer Overflow
/wiki/keylogger	Keylogger
/wiki/polly-klaas	Polly Klaas
/wiki/antivirus	Antivirus
/wiki/kid-mode	Kid Mode
/wiki/portal	Portal
/wiki/amazon-prime	Amazon Prime
/wiki/how-disable-incognito-mode-chrome	How to Disable Incognito Mode in Chrome
/wiki/ask-ninja	Ask a Ninja
/wiki/sicom	SI.com
/wiki/how-disable-pop-ups-safari	How to Disable Pop-Ups in Safari
/wiki/virtual-private-networks-vpns	Virtual Private Networks (VPNs)
/wiki/voip	VoIP
/wiki/how-block-images-firefox	How to Block Images in Firefox
/wiki/thisiswhyimbroke	ThisIsWhyImBroke
/wiki/clamwin	Clamwin
/wiki/coppa	COPPA
/wiki/norton-antivirus-mac	Norton AntiVirus for Mac
/wiki/opendns-setting-internet-filtering-windows-7	OpenDNS - Setting up Internet Filtering in Windows 7
/wiki/flash-cookies	Flash cookies
/wiki/obama-girl	Obama Girl
/wiki/turntablefm	Turntable.fm
/wiki/stuff-white-people	Stuff White People Like
/wiki/internet-safety-news	Internet Safety News
/wiki/lookstoogoodtobetruecom	LooksTooGoodToBeTrue.com
/wiki/security-passcode-variety	Security in Passcode Variety
/wiki/aurora-password-manager	Aurora Password Manager
/wiki/scareware	Scareware
/wiki/lifehackercom	lifehacker.com
/wiki/gamesspot	GamesSpot
/wiki/pawngamecom	PawnGame.com
/wiki/bullybust	BullyBust
/wiki/attachments	Attachments
/wiki/books-about-facebook	Books About Facebook
/wiki/computerworldcom	Computerworld.com
/wiki/entertonement	Entertonement
/wiki/snapchat	Snapchat
/wiki/peers2peers	Peers2Peers
/wiki/nprorg	npr.org
/wiki/berkman-center-internet-and-society	Berkman Center For Internet and Society
/wiki/double-rainbow	Double Rainbow
/wiki/auto-tune-news	Auto-tune the news
/wiki/funny-or-die	Funny or Die
/wiki/hackers-china-edition	Hackers, China Edition
/wiki/google-goggles	Google Goggles
/wiki/sparknotes	SparkNotes
/wiki/mmorpgs	MMORPGs
/wiki/kidscom	KidsCom
/wiki/reputationdefender	ReputationDefender
/wiki/gamespy	GameSpy
/wiki/zero-day-attacks	Zero-Day Attacks
/wiki/speed-runs-live	Speed Runs Live
/wiki/sharpenednet	Sharpened.net
/wiki/gamedevnet	GameDev.net
/wiki/veoh	Veoh
/wiki/fallout-3	Fallout 3
/wiki/uk-phone-hacking-scandal	UK Phone Hacking Scandal
/wiki/player-vs-environment	Player vs Environment
/wiki/ninitecom	Ninite.com
/wiki/national-center-bullying-prevention	National Center for Bullying Prevention
/wiki/baby-monkey	Baby Monkey
/wiki/bad-lip-reading	Bad Lip Reading
/wiki/myprivacy	MyPrivacy
/wiki/national-domestic-violence-hotline	National Domestic Violence Hotline
/wiki/antispyware	Antispyware
/wiki/angry-birds	Angry Birds
/wiki/jaiku	Jaiku
/wiki/search-engine-optimization	Search Engine Optimization
/wiki/mylifeisaverage	MyLifeIsAverage
/wiki/how-disable-inprivate-internet-explorer	How to Disable InPrivate in Internet Explorer
/wiki/online-comics	Online comics
/wiki/soompicom	Soompi.com
/wiki/dailymotion	DailyMotion
/wiki/ssd-solid-state-drivers-my-hard-drive-will-never-crash-again	SSD- Solid State Drivers-My hard drive will never crash again!
/wiki/mog-music	MOG music
/wiki/podcasts	Podcasts
/wiki/sticky-drama	Sticky Drama
/wiki/antoine-dodson	Antoine Dodson
/wiki/respectucom	Respectu.com
/wiki/neatorama	Neatorama
/wiki/filmaffinity	FilmAffinity
/wiki/mobile-internet	Mobile Internet
/wiki/celia-blay	Celia Blay
/wiki/manga	Manga
/wiki/internet-safety-organizations-and-products	Internet Safety Organizations and Products
/wiki/flappy-bird	Flappy Bird
/wiki/homework-help-websites	Homework "Help" Websites
/wiki/justin-bieber-800-slower	Justin Bieber 800% Slower
/wiki/joost	Joost
/wiki/facebook-memes	Facebook Memes
/wiki/ripple-reader	Ripple Reader
/wiki/incredible-internet	Incredible Internet
/wiki/youtube-leanback	YouTube Leanback
/wiki/blogger	Blogger
/wiki/pewdiepie	PewDiePie
/wiki/other-software	Other Software
/wiki/how-filter-explicit-songs-pandora	How to Filter Explicit Songs from Pandora
/wiki/cardomain	CarDomain
/wiki/mcafee-family-protection	McAfee Family Protection
/wiki/storyline-online	Storyline Online
/wiki/gamecrush	GameCrush
/wiki/flyordiecom	FlyorDie.com
/wiki/microsoft-surface	Microsoft Surface
/wiki/dangers-incognito-mode-chrome-and-other-browsers	The Dangers of Incognito Mode for Chrome and Other Browsers
/wiki/entropia-universe	Entropia Universe
/wiki/ipod	IPod
/wiki/loldogs	Loldogs
/wiki/bitcoin	Bitcoin
/wiki/steven-anthony-ballmer	Steven Anthony Ballmer
/wiki/arm-adult-filter	Arm Adult Filter
/wiki/go-try-it	Go Try It On
/wiki/distant-suns	Distant Suns
/wiki/virtual-communities	Virtual Communities
/wiki/somethingawfulcom	SomethingAwful.com
/wiki/oovoo	ooVoo
/wiki/teenangelsorg	Teenangels.org
/wiki/audiopal	AudioPal
/wiki/windows-vista	Windows Vista
/wiki/ryan-halligan	Ryan Halligan
/wiki/find-my-phone-android-app	Find My Phone Android App
/wiki/distro	Distro
/wiki/kids-place	Kids Place
/wiki/twitchtv	Twitch.tv
/wiki/worms	Worms
/wiki/project-gutenberg	Project Gutenberg
/wiki/antivirus-spy-sweeper	Antivirus with Spy Sweeper
/wiki/bittorrent	BitTorrent
/wiki/hacker-news	Hacker News
/wiki/zoosk	Zoosk
/wiki/yahoo-safely	Yahoo! Safely
/wiki/1000-awesome-things	1000 Awesome Things
/wiki/myreputation	MyReputation
/wiki/phonezoo	Phonezoo
/wiki/mediocre-films	Mediocre Films
/wiki/android-content-filter-browser-apps	Android Content Filter Browser Apps
/wiki/content-farms	Content Farms
/wiki/friendfeed	FriendFeed
/wiki/tineye-reverse-image-search	TinEye Reverse Image Search
/wiki/graph-jam	Graph Jam
/wiki/world-wide-web	World Wide Web
/wiki/facebook-obsession	The Facebook Obsession
/wiki/avg-anti-virus-plus-firewall	AVG Anti-Virus Plus Firewall
/wiki/compulsion-solutions	Compulsion Solutions
/wiki/i-can-has-cheezburger	I Can Has Cheezburger
/wiki/playstation	Playstation
/wiki/urban-dictionary	Urban Dictionary
/wiki/photoblogging	Photoblogging
/wiki/movie-trailers	Movie Trailers
/wiki/its-your-sex-life	Its Your (Sex) Life
/wiki/vlogsvloggers	Vlogs/Vloggers
/wiki/how-examine-security-certificates-netscape	How to Examine Security Certificates in Netscape
/wiki/easyflirt	EasyFlirt
/wiki/smoking-gun	The Smoking Gun
/wiki/email-inbox-management	Email Inbox Management
/wiki/bots	Bots
/wiki/kongregate	Kongregate
/wiki/helpguideorg	Helpguide.org
/wiki/bitdefender-internet-security-2011	BitDefender Internet Security 2011
/wiki/sid-science-kid	Sid the Science Kid
/wiki/emsisoft-anti-malware	Emsisoft Anti-Malware
/wiki/legal-online-music-websites	Legal Online Music Websites
/wiki/about-us	About Us
/wiki/throttling	Throttling
/wiki/how-block-website	How to block a website
/wiki/siri	Siri
/wiki/tools-help-users-protect-their-privacy	Tools to help users protect their privacy
/wiki/mmo-guild	MMO Guild
/wiki/fabulis	Fabulis
/wiki/parentscom	Parents.com
/wiki/pro-ana-websites	Pro-ana Websites
/wiki/liquid-mountaineering	Liquid mountaineering
/wiki/iphone	IPhone
/wiki/imeem	Imeem
/wiki/lexipixel	LexiPixel
/wiki/grandparentstlc	GrandparentsTLC
/wiki/how-configure-built-firewall-android-phones-using-droidwall	How to configure the built-in firewall in Android Phones using DroidWall
/wiki/1up	1up
/wiki/get-safe-online	Get Safe Online
/wiki/harry-potter	Harry Potter
/wiki/hipster-ariel	Hipster Ariel
/wiki/rune-scape	Rune Scape
/wiki/encryption	Encryption
/wiki/count-us	Count Us In
/wiki/cookie-sidejacking	Cookie Sidejacking
/wiki/verizon-parental-controls-center	Verizon Parental Controls Center
/wiki/speak2tweet	Speak2Tweet
/wiki/free-advice	Free Advice
/wiki/how-set-blog-blogger	How to Set Up a Blog on Blogger
/wiki/followers	Followers
/wiki/star-wars-old-republic	Star Wars: The Old Republic
/wiki/mapquest	MapQuest
/wiki/netfamilynewsorg	Netfamilynews.org
/wiki/norton	Norton
/wiki/erfworld	Erfworld
/wiki/email	Email
/wiki/noahs-internet	Noah's Internet
/wiki/cryptography	Cryptography
/wiki/sean-parker	Sean Parker
/wiki/downloads	Downloads
/wiki/whats-big-deal-about-pornography-book	What's the Big Deal About Pornography? (book)
/wiki/potter-puppet-pals	Potter Puppet Pals
/wiki/agnitum	Agnitum
/wiki/heroes-newerth	Heroes of Newerth
/wiki/sourceforge	SourceForge
/wiki/microsoft-security-essentials	Microsoft Security Essentials
/wiki/ashampoo-firewall	Ashampoo Firewall
/wiki/adware	Adware
/wiki/kidsgov	Kids.gov
/wiki/espin	ESpin
/wiki/blocking	Blocking
/wiki/books-written-kids	Books Written for Kids
/wiki/lulzsec	Lulzsec
/wiki/safesurfingkidscom	SafeSurfingKids.com
/wiki/tigertext	TigerText
/wiki/how-create-safe-username	How to Create a Safe Username
/wiki/graduatescom	Graduates.com
/wiki/hoax-slayer	Hoax-Slayer
/wiki/picasa	Picasa
/wiki/ipod-shuffle	IPod Shuffle
/wiki/cookies-and-ads	Cookies and Ads
/wiki/internet-watch-foundation	Internet Watch Foundation
/wiki/anime	Anime
/wiki/blippr	Blippr
/wiki/cybersafe247	CyberSafe247
/wiki/wikis	Wikis
/wiki/zoobuh	Zoobuh
/wiki/mstar	Mstar
/wiki/free-trial-offers	Free Trial Offers
/wiki/next-sports	Up Next In Sports
/wiki/homestarrunnercom	Homestarrunner.com
/wiki/square	Square
/wiki/ever-quest	Ever Quest
/wiki/own-your-space	Own Your Space
/wiki/yippy	Yippy
/wiki/philanthropercom	Philanthroper.com
/wiki/how-disable-pop-ups-chrome	How to Disable Pop-Ups in Chrome
/wiki/x3watch-android	x3watch-android
/wiki/net-nanny-home-suite	Net Nanny Home Suite
/wiki/disneycom	Disney.com
/wiki/trisphee	Trisphee
/wiki/there-i-fixed-it	There, I Fixed It
/wiki/call-me-maybe	Call Me Maybe
/wiki/warning-signs-kids-viewing-pornography	Warning Signs for Kids Viewing Pornography
/wiki/avg	AVG
/wiki/couch-surfing	Couch Surfing
/wiki/adminstrator	Adminstrator
/wiki/online-dating	Online Dating
/wiki/lol-e-sports	LoL E-Sports
/wiki/ashampoo	Ashampoo
/wiki/online-games	Online Games
/wiki/how	How?
/wiki/julian-smith-internet-videos	Julian Smith Internet Videos
/wiki/guild-wars	Guild Wars
/wiki/cyberstalking	Cyberstalking
/wiki/mayocliniccom	MayoClinic.com
/wiki/dropbox	DropBox
/wiki/nintendo-wii-u	Nintendo Wii U
/wiki/connect-kids	Connect with kids
/wiki/espncom	ESPN.com
/wiki/how-create-new-articles	How to Create New Articles
/wiki/epic-meal-time	Epic Meal Time
/wiki/what-are-security-certificates	What are security certificates?
/wiki/liveleak	LiveLeak
/wiki/hulu-plus	Hulu Plus
/wiki/pop-ups	Pop-Ups
/wiki/people-walmart	People of Walmart
/wiki/qr-code	QR Code
/wiki/consumerreportsorg	consumerreports.org
/wiki/legalsoundscom	Legalsounds.com
/wiki/metacafe	MetaCafe
/wiki/gif	gif
/wiki/kidshealthorg	KidsHealth.org
/wiki/hashtag	Hashtag
/wiki/ultraviolet	Ultraviolet
/wiki/real-meaning-mph	The Real Meaning of MPH
/wiki/rollyo	Rollyo
/wiki/esrb-ratings	ESRB ratings.
/wiki/facecrooks	facecrooks
/wiki/kat-lowe	Kat Lowe
/wiki/squidoo	Squidoo
/wiki/smoshcom	Smosh.com
/wiki/mobs	Mobs
/wiki/odiogo	Odiogo
/wiki/plagiarismorg	Plagiarism.org
/wiki/ksl-classified-ads-and-cars	KSL Classified Ads and Cars
/wiki/os-x	OS X
/wiki/nindb	NinDB
/wiki/backup-products	Backup Products
/wiki/internet-security-essentials	Internet Security Essentials
/wiki/literal-music-videos	Literal Music Videos
/wiki/matrimonial-websites	Matrimonial websites
/wiki/video-sharing	Video Sharing
/wiki/blocking-ads-firefox	Blocking Ads in Firefox
/wiki/librarything	LibraryThing
/wiki/vmythscom	Vmyths.com
/wiki/kideos	Kideos
/wiki/uncyclopedia	uncyclopedia
/wiki/how-format-text	How to Format Text
/wiki/diablo-ii	Diablo II
/wiki/threatfire	ThreatFire
/wiki/net-mom	Net-mom
/wiki/dressup-me	Dressup Me
/wiki/views-catholic-leaders-regarding-internet	Views of Catholic Leaders Regarding the Internet
/wiki/photo-sharing	Photo Sharing
/wiki/virus	Virus
/wiki/internet-safety-while-abroad	Internet Safety while Abroad
/wiki/soundcloud	Soundcloud
/wiki/duck-duck-go	Duck Duck Go
/wiki/cyber-safety	Cyber Safety
/wiki/family-internet-safety	Family Internet Safety
/wiki/badoo	Badoo
/wiki/gogonewscom	gogonews.com
/wiki/perezhilton	PerezHilton
/wiki/social-engineering	Social Engineering
/wiki/netsmartz	NetSmartz
/wiki/street-view	Street View
/wiki/opendns	OpenDNS
/wiki/steve-jobs	Steve Jobs
/wiki/gawkk	Gawkk
/wiki/dinosaur-train	Dinosaur Train
/wiki/imageshack	Imageshack
/wiki/hot-coffee	Hot Coffee
/wiki/certorg	cert.org
/wiki/smell-monster	Smell Like A Monster
/wiki/tvtropes	TvTropes
/wiki/memes	Memes
/wiki/futility-closet	Futility Closet
/wiki/hovercard	Hovercard
/wiki/windows-7-firewall	Windows 7 Firewall
/wiki/detecting-malicious-emails-opening-them	Detecting Malicious Emails Before Opening Them
/wiki/monster	Monster
/wiki/safe2read	Safe2Read
/wiki/mommy-blogs	Mommy Blogs
/wiki/hentai-and-ecchi	Hentai and Ecchi
/wiki/google-nexus	Google Nexus
/wiki/dealmap	The Dealmap
/wiki/how-disable-private-browsing-firefox	How to Disable Private Browsing in Firefox
/wiki/mac	Mac
/wiki/justin-bieber	Justin Bieber
/wiki/soundsnap	Soundsnap
/wiki/how-examine-security-certificates-internet-explorer	How to Examine Security Certificates in Internet Explorer
/wiki/acronyms	Acronyms
/wiki/mormon-messages	Mormon Messages
/wiki/livingsocial	LivingSocial
/wiki/yammer	Yammer
/wiki/ipad	IPad
/wiki/rebecca-black	Rebecca Black
/wiki/dailysteals	DailySteals
/wiki/net-nanny-mobile	Net Nanny Mobile
/wiki/netflix	Netflix
/wiki/firewallguidecom	firewallguide.com
/wiki/zooomr	Zooomr
/wiki/do-not-call-list	Do not call list
/wiki/ubisoft-uplay	Ubisoft Uplay
/wiki/comic-genesis	Comic Genesis
/wiki/mingles	Mingles
/wiki/putty	PuTTY
/wiki/panda-antivirus-mac	Panda Antivirus for Mac
/wiki/veggiedate	VeggieDate
/wiki/esa	ESA
/wiki/neopets	Neopets
/wiki/dangers-snapchat	Dangers of Snapchat 
/wiki/teamviewer	TeamViewer
/wiki/lavalife	LavaLife
/wiki/viddler	Viddler
/wiki/mozilla-firefox	Mozilla Firefox
/wiki/cybersitter	CyberSitter
/wiki/ad	Ad
/wiki/how-block-images-safari	How to Block Images in Safari
/wiki/internet-child-safety	Internet Child Safety
/wiki/spyware	Spyware
/wiki/over-sharing	Over-sharing
/wiki/internet-safety-project-video-library	The Internet Safety Project Video Library
/wiki/beemp3	Beemp3
/wiki/thinkuknow	ThinkUKnow
/wiki/ocremixorg	Ocremix.org
/wiki/internet-suicide	Internet Suicide
/wiki/zooborns	ZooBorns
/wiki/google-play-music	Google Play Music
/wiki/virtual-worlds	Virtual Worlds
/wiki/keeping-your-web-accounts-safe	Keeping your web accounts safe
/wiki/google-wallet	Google Wallet
/wiki/roflrazzi	Roflrazzi
/wiki/total-war	Total War
/wiki/american-dialect-societys-word-year	American Dialect Society's Word of the Year
/wiki/virtual-machine	Virtual Machine
/wiki/maddox	Maddox
/wiki/enigma-group	Enigma Group
/wiki/icloud	iCloud
/wiki/all-your-base-are-belong-us	All Your Base Are Belong to Us
/wiki/playstation-4	PlayStation 4
/wiki/garrys-mod	Garry's Mod
/wiki/telnet	Telnet
/wiki/nasa-app	NASA app
/wiki/cyberdefender	CyberDefender
/wiki/rocketboom	Rocketboom
/wiki/windows-81	Windows 8.1
/wiki/parental-controls-windows-vista	Parental Controls for Windows Vista
/wiki/non-player-character	Non-Player Character
/wiki/math-playground	Math Playground
/wiki/clickjacking	Clickjacking
/wiki/web-wise-kids	Web Wise Kids
/wiki/majorgeekscom	MajorGeeks.com
/wiki/pornographic-image-recognition	Pornographic Image Recognition
/wiki/recaptcha	reCAPTCHA
/wiki/javascript	Javascript
/wiki/livejournal	LiveJournal
/wiki/smartphone	Smartphone
/wiki/how-block-flash	How to Block Flash
/wiki/family-cyber-alert	Family Cyber Alert
/wiki/task-bar	Task Bar
/wiki/disabling-social-network-accounts-deceased-users	Disabling Social Network Accounts of Deceased Users
/wiki/jorimslistcom	Jorimslist.com
/wiki/wordgirl	WordGirl
/wiki/att-safteyland	AT&T SafteyLand
/wiki/online-gamers-anonymous	Online Gamers Anonymous
/wiki/facebook	Facebook
/wiki/viruses-posing-antivirus-software	Viruses Posing as Antivirus Software
/wiki/amitbhawanicom	amitbhawani.com
/wiki/christiannet	ChristianNet
/wiki/internet-safety-center	Internet Safety Center
/wiki/wired-moms	Wired Moms
/wiki/how-examine-security-certificates-opera	How to Examine Security Certificates in Opera
/wiki/trend-micro	Trend Micro
/wiki/5-tips-picking-strong-password	5 Tips For Picking A Strong Password
/wiki/windows-8	Windows 8
/wiki/podomatic	Podomatic
/wiki/dumpcom	DUMP.com
/wiki/windows-7	Windows 7
/wiki/ways-access-internet	Ways to Access the Internet
/wiki/eve-online	Eve Online
/wiki/acquisition	Acquisition
/wiki/staynalive	StayNAlive
/wiki/google-maps	Google Maps
/wiki/playstation-3	Playstation 3
/wiki/videochat	Videochat
/wiki/how-access-browsing-history-google-chrome	How to Access Browsing History in Google Chrome
/wiki/girl-scouts-usa	Girl Scouts of the USA
/wiki/last-lecture	The Last Lecture
/wiki/flyff	FlyFF
/wiki/wiredkids	WiredKids
/wiki/captcha	Captcha
/wiki/sex-offender-tracker	Sex Offender Tracker
/wiki/what-pikluk	What is Pikluk?
/wiki/digital-shepherds	Digital Shepherds
/wiki/hoaxbustersorg	Hoaxbusters.org
/wiki/tagpro	TagPro
/wiki/how-online-predators-work	How online predators work
/wiki/addictinggames	AddictingGames
/wiki/educational-cyberplayground	Educational CyberPlayGround
/wiki/software-macs	Software for Macs
/wiki/cosplay	Cosplay
/wiki/bitly	Bit.ly
/wiki/tablet	Tablet
/wiki/virtual-addictioncom	virtual-addiction.com
/wiki/how-use-watch-history-youtube	How to Use Watch History on YouTube
/wiki/fotki	Fotki
/wiki/hacktivism	Hacktivism
/wiki/allfacebook	Allfacebook
/wiki/vindictus	Vindictus
/wiki/ijustine	ijustine
/wiki/airmp3	AirMp3
/wiki/chatroulette	Chatroulette
/wiki/doubleclick	doubleClick
/wiki/red-bunny-trojan	Red Bunny Trojan
/wiki/wepay	WePay
/wiki/katiesplaceorg	Katiesplace.org
/wiki/glozell	GloZell
/wiki/ventrilo	Ventrilo
/wiki/how-set-twitter-account	How to Set Up a Twitter Account
/wiki/youtube-channel	YouTube Channel
/wiki/newgrounds	Newgrounds
/wiki/articles-needing-expansion	Articles Needing Expansion
/wiki/5-things-you-can-do-make-your-computer-faster	5 things you can do to make your computer faster
/wiki/zazzle	Zazzle
/wiki/rhett-link	Rhett & Link
/wiki/megavideo	MegaVideo
/wiki/avast-internet-security	Avast! Internet Security
/wiki/identity-theft-children	Identity Theft (Children)
/wiki/world-warcraft	World of Warcraft
/wiki/ftl-faster-light	FTL: Faster Than Light
/wiki/online-safety-software-kids	Online Safety Software for Kids
/wiki/poogling	Poogling
/wiki/ftp	FTP
/wiki/cyberbullyingorg	Cyberbullying.org
/wiki/everything2	everything2
/wiki/vuvuzelas	Vuvuzelas
/wiki/verizon	Verizon
/wiki/frappr	Frappr
/wiki/big-fish-games	Big Fish Games
/wiki/cybersnitchnet	cybersnitch.net
/wiki/connectsafely	ConnectSafely
/wiki/buzzle	Buzzle
/wiki/imap	IMAP
/wiki/webcams	Webcams
/wiki/encryption-software	Encryption Software
/wiki/avg-internet-security	AVG Internet Security
/wiki/peers2peersorg	Peers2peers.org
/wiki/cloud-computing	Cloud Computing
/wiki/rootkits	Rootkits
/wiki/common-internet-slang	Common Internet Slang
/wiki/beatbullyingorg	Beatbullying.org 
/wiki/10-best-ways-protect-your-identity-online	10 Best Ways to Protect Your Identity Online
/wiki/club-penguin	Club Penguin
/wiki/books-about-general-internet-safety	Books About General Internet Safety
/wiki/cooks-source	Cooks Source
/wiki/freeware	Freeware
/wiki/stackexchange	StackExchange
/wiki/mcgruff-browser-kids	McGruff Browser for Kids
/wiki/diynetworkcom	Diynetwork.com
/wiki/rappelz	Rappelz
/wiki/blabberize	Blabberize
/wiki/familysafecomputersorg	Familysafecomputers.org
/wiki/nintendo-network	Nintendo Network
/wiki/thevergecom	TheVerge.com
/wiki/protect-ip-act-pipa	PROTECT IP Act (PIPA)
/wiki/ddos-attack	DDoS Attack
/wiki/bomb-mp3	Bomb-Mp3
/wiki/sexaholics-anonymous	Sexaholics Anonymous
/wiki/yoursphere	YourSphere
/wiki/megan-meier	Megan Meier
/wiki/tv-links-eu	TV Links eu
/wiki/galaxy-zoo	Galaxy Zoo
/wiki/kids-and-ipods	Kids and iPods
/wiki/blockem	Block'em
/wiki/babylon-search-toolbar	Babylon Search Toolbar
/wiki/internet-basics	Internet Basics
/wiki/online-games-addiction	Online Games Addiction
/wiki/mister-rogers%E2%80%99-neighborhood	Mister Rogers’ Neighborhood
/wiki/pulse	Pulse 
/wiki/dogpile	Dogpile
/wiki/how-create-safe-facebook-account	How to Create a Safe Facebook Account
/wiki/xanga	Xanga
/wiki/spam-comments	Spam Comments
/wiki/facescom	Faces.com
/wiki/client-program	Client Program
/wiki/crowdsourcing	crowdsourcing
/wiki/postsecret	PostSecret
/wiki/csnorg	CSN.org
/wiki/uknow	uKnow
/wiki/matchcom	Match.com
/wiki/social-media-sobriety-test	Social Media Sobriety Test
/wiki/whatswhat	WhatsWhat
/wiki/mosaic	Mosaic
/wiki/words-friends	Words With Friends
/wiki/comment	Comment
/wiki/paypal	PayPal
/wiki/skid-e-kids	Skid-e-Kids
/wiki/click-jacking	click-jacking
/wiki/personal-internet-security-2010	Personal Internet Security 2010
/wiki/opera	Opera
/wiki/kazaa	Kazaa
/wiki/thinkfamilysafetycom	Thinkfamilysafety.com
/wiki/norton-online-family	Norton Online Family
/wiki/digital-citizenship	Digital Citizenship
/wiki/truecrypt	TrueCrypt
/wiki/christianmingle	ChristianMingle
/wiki/how-create-gmail-account	How to Create a Gmail Account
/wiki/peanut-butter-jelly-time	Peanut Butter Jelly Time
/wiki/casey-haynes	Casey Haynes
/wiki/location-based-social-networking	Location Based Social Networking
/wiki/open-source	Open Source
/wiki/blizzard	Blizzard
/wiki/identity-theft	Identity Theft
/wiki/good-know	Good to Know
/wiki/drudge-report	Drudge Report
/wiki/netlingocom	Netlingo.com
/wiki/how-make-your-computer-start-quicker	How to make your computer start up quicker
/wiki/angies-list	Angie's List
/wiki/league-legends	League of Legends
/wiki/nextag	NexTag
/wiki/rickrolling	Rickrolling
/wiki/cia-world-factbook	CIA World Factbook
/wiki/freemium	Freemium
/wiki/jolly-rogers-cookbook	Jolly Roger's Cookbook
/wiki/deseret-connect	Deseret Connect
/wiki/child-pornography	Child Pornography
/wiki/how-access-browsing-history-safari	How to Access Browsing History in Safari
/wiki/viral-video	Viral Video
/wiki/foursquare	Foursquare
/wiki/mobicip	Mobicip
/wiki/how-access-browsing-history-opera	How to Access Browsing History in Opera
/wiki/kidlogger	KidLogger
/wiki/yahoo-answers	Yahoo! Answers
/wiki/how-do-i-use-site	How Do I Use the Site
/wiki/thepiratebayorg	thepiratebay.org
/wiki/saavi-accountability	Saavi accountability
/wiki/yelp	Yelp
/wiki/routers	Routers
/wiki/books-about-cyberbullying	Books About Cyberbullying
/wiki/funny-pics	Funny Pics
/wiki/organizations-parents	Organizations for Parents
/wiki/overly-attached-girlfriend	Overly Attached Girlfriend
/wiki/setting-opendns-ios-ipod-ipad-wifi-only	Setting up OpenDNS - iOS (iPod, iPad WiFi Only)
/wiki/funamo-parental-control	Funamo Parental Control
/wiki/freedom-begins-here	Freedom Begins Here
/wiki/friends	Friends
/wiki/windows-defender	Windows Defender
/wiki/web-series	Web Series
/wiki/cnetcom	Cnet.com
/wiki/firewall-software	Firewall Software
/wiki/safe-email-services-kids	Safe Email Services for Kids
/wiki/sartorialist	The Sartorialist
/wiki/rift	Rift
/wiki/outpost-network-security	Outpost Network Security
/wiki/ccmostwantedcom	ccmostwanted.com
/wiki/passwords	Passwords
/wiki/avg-antivirus-free	AVG Antivirus Free
/wiki/grand-theft-auto	Grand Theft Auto
/wiki/password-tiering-principle	Password Tiering Principle
/wiki/oauth	OAuth
/wiki/cyberchase	Cyberchase
/wiki/modem	Modem
/wiki/safari	Safari
/wiki/linda-criddle	Linda Criddle
/wiki/staysafeonline	StaySafeOnline
/wiki/apple	Apple
/wiki/security-token	Security Token
/wiki/frontierville	FrontierVille
/wiki/net-nanny-65	Net Nanny 6.5
/wiki/clifford-big-red-dog	Clifford the Big Red Dog
/wiki/city-heroes-city-villains	City of Heroes/ City of Villains
/wiki/achmed-dead-terrorist	Achmed the Dead Terrorist
/wiki/wordpress	WordPress
/wiki/grokster	Grokster
/wiki/bewebawareca	bewebaware.ca
/wiki/cuil	Cuil
/wiki/mention	@Mention
/wiki/connected4safety	Connected4safety
/wiki/mark-drybrough	Mark Drybrough
/wiki/playfish	Playfish
/wiki/search-engines	Search Engines
/wiki/provident-living-addiction-recovery-program	Provident Living Addiction Recovery Program
/wiki/social-networking	Social Networking
/wiki/ashampoo-anti-malware	Ashampoo Anti-Malware
/wiki/player-character	Player Character
/wiki/cyber-marriage	Cyber marriage
/wiki/facemoods	Facemoods
/wiki/eharmony	EHarmony
/wiki/playlistcom	Playlist.com
/wiki/dark-age-camelot	Dark Age of Camelot
/wiki/lovestruck	Lovestruck
/wiki/portal-2	Portal 2
/wiki/vgcats	VGCats
/wiki/evony	Evony
/wiki/pointsmartclicksafeorg	Pointsmartclicksafe.org
/wiki/voki	Voki
/wiki/hosts-file	Hosts File
/wiki/frontline-growing-online	Frontline: Growing Up Online
/wiki/sms-android-trojan	SMS Android Trojan
/wiki/widget	Widget
/wiki/i-whip-my-hair-back-and-forth	I Whip My Hair Back and Forth
/wiki/mocospace	MocoSpace
/wiki/photoshopcom	Photoshop.com
/wiki/purevolumecom	PureVolume.com
/wiki/professional-networking	Professional Networking
/wiki/carnegie-cyber-academy	Carnegie Cyber Academy
/wiki/laptops	Laptops
/wiki/blogscope	BlogScope
/wiki/java	Java
/wiki/double-twist	Double Twist
/wiki/askkidscom	AskKids.com
/wiki/everloop	Everloop
/wiki/how-install-no-script-firefox	How to Install No Script in Firefox
/wiki/file-backup	File Backup
/wiki/phishing	Phishing
/wiki/zune-marketplace-music	Zune Marketplace Music
/wiki/skyrim	Skyrim
/wiki/pc-pandora	PC Pandora
/wiki/contentcleanup	ContentCleanup
/wiki/how-block-images-opera	How to Block Images in Opera
/wiki/ashampoo-magical-security	Ashampoo Magical Security
/wiki/microsoft-online-safety	Microsoft Online Safety
/wiki/extensions	Extensions
/wiki/google-product-search	Google Product Search
/wiki/my-body-gallery	My Body Gallery
/wiki/pup-potentially-unwanted-program	PUP (Potentially Unwanted Program)
/wiki/besafe-internet-safety	BeSafe Internet Safety
/wiki/internet-safety-wiki	The Internet Safety Wiki
/wiki/ehowcom	eHow.com
/wiki/man-middle-attackmitm	Man-in-the-middle Attack(MITM)
/wiki/ecademy	Ecademy
/wiki/new-familysearch	New FamilySearch
/wiki/zorpia	Zorpia
/wiki/ilookbothways	ILookBothWays
/wiki/yahoo-pulse	Yahoo! Pulse
/wiki/albino-blacksheep	Albino Blacksheep
/wiki/comvigo	Comvigo
/wiki/google-safe-search	Google Safe Search
/wiki/pornography	Pornography
/wiki/stickam	Stickam
/wiki/yahoo-mail	Yahoo! Mail
/wiki/social-media-day	Social Media Day
/wiki/cyberterrorism	Cyberterrorism
/wiki/mike-morhaime	Mike Morhaime
/wiki/firefox-easy-youtube-video-downloader	Firefox Easy YouTube Video Downloader
/wiki/jeff-bezos	Jeff Bezos
/wiki/best-free-internet-filter-k-9-blue-coat	The best, free internet filter: K-9 from Blue Coat
/wiki/how-block-images-internet-explorer	How to Block Images in Internet Explorer
/wiki/keyloggers-and-how-avoid-them	Keyloggers And How To Avoid Them
/wiki/broadband	Broadband
/wiki/beauty-redefinednet	Beauty Redefined.net
/wiki/bearshare	BearShare
/wiki/backdoor	Backdoor
/wiki/cyber-citizen	Cyber Citizen
/wiki/password-managers	Password Managers
/wiki/internet-movie-database	Internet Movie Database
/wiki/ninja-kiwi	Ninja Kiwi
/wiki/salfeld	Salfeld
/wiki/how-download-internet-explorer	How to Download Internet Explorer
/wiki/megaupload	Megaupload
/wiki/cupid-dot-com-legitimate-dating-site-or-scam	Cupid Dot Com - Legitimate Dating Site or Scam?
/wiki/hypertexting	Hypertexting
/wiki/netsafekids	NetSafeKids
/wiki/zune-hd-media-player	Zune HD Media Player
/wiki/engrish	Engrish
/wiki/cybersex	Cybersex
/wiki/youthbetnet	Youthbet.net
/wiki/aboutcom	About.com
/wiki/digital-piracy	Digital Piracy
/wiki/it-gets-better	It Gets Better
/wiki/my-mobile-watchdog	My Mobile Watchdog
/wiki/hacked	hacked
/wiki/whitest-kids-u-know	The Whitest Kids U' Know
/wiki/xbmc	XBMC
/wiki/wordworld	WordWorld
/wiki/bandcampcom-music	Bandcamp.com Music
/wiki/setting-opendns-mac-os-x	Setting up OpenDNS - Mac OS X
/wiki/organizations-cyberbullying	Organizations on Cyberbullying
/wiki/teen-chat-decoder	Teen Chat Decoder
/wiki/team-fortress-2	Team Fortress 2
/wiki/hotscamscom	Hotscams.com
/wiki/social-network	The Social Network
/wiki/blocking-ads-google-chrome-0	Blocking Ads in Google Chrome
/wiki/mmog	MMOG
/wiki/ios-6	iOS 6
/wiki/evolution-dance	Evolution of Dance
/wiki/ios-5	iOS 5
/wiki/spyware-doctor	Spyware Doctor
/wiki/outpost-firewall-pro	Outpost Firewall PRO
/wiki/gizmodocom	Gizmodo.com
/wiki/mobicip-monitor	Mobicip Monitor
/wiki/stumbleupon	StumbleUpon
/wiki/changeorg	Change.org
/wiki/app	App
/wiki/free-software	Free Software
/wiki/how-access-browsing-history-internet-explorer	How to Access Browsing History in Internet Explorer
/wiki/jumo	Jumo
/wiki/tumblr	Tumblr
/wiki/smart-phone-security	Smart Phone Security
/wiki/blackberry	BlackBerry
/wiki/pandoras-hope	Pandora's Hope
/wiki/spy-sweeper	Spy Sweeper
/wiki/web-trust	Web of Trust
/wiki/addiction-recovery-organizations	Addiction Recovery Organizations
/wiki/national-crime-prevention-council	National Crime Prevention Council
/wiki/howstuffworkscom	HowStuffWorks.com
/wiki/audiofarm	Audiofarm
/wiki/annoying-orange	Annoying Orange
/wiki/https	HTTPS
/wiki/what-does-fox-say	What Does The Fox Say?
/wiki/amazon-mp3	Amazon MP3
/wiki/cocoperez	CocoPerez
/wiki/web-safety	Web Safety
/wiki/federer-trick-shot-video	Federer Trick Shot Video
/wiki/alloy	Alloy
/wiki/slashdot	Slashdot
/wiki/threadless	Threadless
/wiki/norton-utilities	Norton Utilities
/wiki/flickr	Flickr
/wiki/phlashing	Phlashing
/wiki/lavasoft-personal-firewall	Lavasoft Personal Firewall
/wiki/cyanide-and-happiness	Cyanide and Happiness
/wiki/dos-attack	DoS Attack
/wiki/sparkpeople	SparkPeople
/wiki/ratemypicture	RateMyPicture
/wiki/destructoid	Destructoid
/wiki/imdb	IMDb
/wiki/susan-boyle	Susan Boyle
/wiki/my-daily-battle-against-pornography	My Daily Battle Against Pornography
/wiki/shane-dawson	Shane Dawson
/wiki/securely-store-credit-card-information-web-site-database	Securely Store Credit Card Information in a Web Site Database
/wiki/leeroy-jenkins	Leeroy Jenkins
/wiki/mod-gaming	Mod: Gaming
/wiki/bad-lip-reading-youtube-channel	Bad Lip Reading (YouTube channel)
/wiki/wikipedia	Wikipedia
/wiki/bing	Bing
/wiki/bsecure-61-plus-antivirus	BSecure 6.1 Plus Antivirus
/wiki/combating-pornography	Combating Pornography
/wiki/editing-guidelines	Editing Guidelines
/wiki/ravelry	Ravelry
/wiki/government-organizations	Government Organizations
/wiki/hotspot-shield	Hotspot Shield
/wiki/hoaxkiller	Hoaxkiller
/wiki/consortium-school-networking	Consortium for School Networking
/wiki/spiral-knights	Spiral Knights
/wiki/pdf	PDF
/wiki/grooming	Grooming
/wiki/myyearbook	MyYearbook
/wiki/qlipboard	Qlipboard
/wiki/kinect	Kinect
/wiki/android-permissions	Android Permissions
/wiki/markdown	Markdown
/wiki/classmatescom	Classmates.com
/wiki/google-hangouts	Google Hangouts
/wiki/zinoko	Zinoko
/wiki/i-waste-so-much-time	I Waste So Much Time
/wiki/trendoy	TrendOY!
/wiki/cyberbee	CyberBee
/wiki/live-disks-cds-dvds-usbs	Live Disks (CDs, DVDs, USBs)
/wiki/vevo	Vevo
/wiki/between-lions	Between the Lions
/wiki/homestar-runner	Homestar Runner
/wiki/internet-keep-safe-coalition	Internet Keep Safe Coalition
/wiki/charity-scams	Charity Scams
/wiki/how-examine-security-certificates-safari	How to Examine Security Certificates in Safari
/wiki/i-turtles-kid	I Like Turtles Kid
/wiki/knowyourmemecom	KnowYourMeme.com
/wiki/ares	Ares
/wiki/cybercrimegov	cybercrime.gov
/wiki/spam	Spam
/wiki/pc-tools-firewall-plus	PC Tools Firewall Plus
/wiki/homeguard-activity-monitor	HomeGuard Activity Monitor
/wiki/eset-nod32-antivirus-4	ESET NOD32 Antivirus 4
/wiki/cybersentinel	CyberSentinel
/wiki/petapixelcom	Petapixel.com
/wiki/adlorg	adl.org
/wiki/desktop-sharing	Desktop Sharing 
/wiki/how-turn-safe-search-google	How to Turn on Safe Search in Google
/wiki/minor-monitor	Minor Monitor
/wiki/android	Android
/wiki/kid-history	Kid History
/wiki/failblog	FailBlog
/wiki/kentucky-center-school-safety	Kentucky Center for School Safety
/wiki/blackplanet	BlackPlanet
/wiki/clone-wars	The Clone Wars
/wiki/film-wall	The Film Wall
/wiki/panda-antivirus-pro-2011	Panda Antivirus Pro 2011
/wiki/bitdefender	BitDefender
/wiki/noisetradecom-music	NoiseTrade.com Music
/wiki/scuttlepad	ScuttlePad
/wiki/websense	Websense
/wiki/windows-live-family-safety	Windows Live Family Safety
/wiki/halo	Halo
/wiki/talking-twin-babies	Talking Twin Babies
/wiki/microsoft-family-safety	Microsoft Family Safety
/wiki/kid-friendly-email	Kid-Friendly Email
/wiki/safe-internet-alliance	Safe Internet Alliance
/wiki/blogpulse	BlogPulse
/wiki/dramatic-look-hamster	Dramatic Look Hamster
/wiki/fail-whale	Fail Whale
/wiki/blogs	Blogs
/wiki/downloadcom	Download.com
/wiki/panda-internet-security-netbooks	Panda Internet Security for Netbooks
/wiki/how-be-good-facebook-parent	How to Be a Good Facebook Parent
/wiki/brainpop	BrainPOP
/wiki/lastpass	Lastpass
/wiki/cheathousecom	Cheathouse.com
/wiki/aboutcom-family-computing	About.com: Family Computing
/wiki/runes-magic	Runes of Magic
/wiki/how-create-giant-hello-account	How to Create a Giant Hello Account
/wiki/how-create-blogger-account	How to Create a Blogger Account
/wiki/national-campaign	The National Campaign
/wiki/edonkey	eDonkey
/wiki/tempalias	Tempalias
/wiki/typosquatting	Typosquatting
/wiki/stuck-tube	Stuck in the Tube
/wiki/operating-systems	Operating Systems
/wiki/candystand	Candystand
/wiki/second-life	Second Life
/wiki/socialshield	SocialShield
/wiki/sporcle	Sporcle
/wiki/dns	DNS
/wiki/safe-kids-usa	Safe Kids USA
/wiki/wiserearth	WiserEarth
/wiki/mp3raid	Mp3Raid
/wiki/parental-controls-android	Parental Controls for Android
/wiki/avira-antivir-premium	Avira Antivir Premium
/wiki/craigslist	Craigslist
/wiki/privacyfix	PrivacyFix
/wiki/pok%C3%A9mon	Pokémon
/wiki/google-reader	Google Reader
/wiki/mcafee-internet-security	McAfee Internet Security
/wiki/cybersmart	CyberSmart!
/wiki/online-gambling	Online gambling
/wiki/nintendo-2ds	Nintendo 2DS
/wiki/stickpage	StickPage
/wiki/reddit	Reddit
/wiki/teen-girl-squad	Teen Girl Squad
/wiki/how-download-opera	How to Download Opera
/wiki/simply-hired	Simply Hired
/wiki/flirtomatic	Flirtomatic
/wiki/stacy-snyder	Stacy Snyder
/wiki/twitter	Twitter
/wiki/hulu	Hulu
/wiki/spotify-music	Spotify Music
/wiki/lottery-scams	Lottery Scams
/wiki/center-safe-and-responsible-internet-use	Center for Safe and Responsible Internet Use
/wiki/voice-chat	Voice Chat
/wiki/blogosphere	Blogosphere
/wiki/pornharmscom	PornHarms.com
/wiki/how-check-cookies-opera	How to Check Cookies in Opera
/wiki/how-update-chrome	How to Update Chrome
/wiki/mod	Mod
/wiki/internet-service-provider	Internet Service Provider
/wiki/organizations	Organizations
/wiki/danahorg	danah.org
/wiki/epicwin	EpicWin
/wiki/gcffreelearnorg-internet-safety-tutorial	GCFFreeLearn.org Internet Safety Tutorial
/wiki/products	Products
/wiki/ted-williams	Ted Williams
/wiki/national-center-missing-exploited-children	National Center for Missing & Exploited Children
/wiki/safe-browsing-habits	Safe browsing habits
/wiki/safe-search-kids	Safe Search Kids
/wiki/instagram	Instagram
/wiki/togetherville	Togetherville
/wiki/final-fantasy-xi	Final Fantasy XI
/wiki/jamendo-music	Jamendo Music
/wiki/fanfictionnet	FanFiction.Net
/wiki/e-commerce	E-Commerce
/wiki/netnanny	NetNanny
/wiki/free-online-dating	Free Online Dating
/wiki/collegeboardorg	collegeboard.org
/wiki/national-network-end-domestic-violence	National Network to End Domestic Violence
/wiki/emoticons	Emoticons
/wiki/electric-company	The Electric Company
/wiki/battleforge	BattleForge
/wiki/norton-ghost	Norton Ghost
/wiki/kids-click	Kids Click
/wiki/how-add-your-article-wiki-outline	How to add your article to the wiki outline
/wiki/project-safe-childhood	Project Safe Childhood
/wiki/how-check-cookies-safari	How to Check Cookies in Safari
/wiki/hyperlinks	Hyperlinks
/wiki/startpage	Startpage
/wiki/cryptographic-key	Cryptographic Key
/wiki/books-about-general-social-networking	Books About General Social Networking
/wiki/facebook-fatigue	Facebook Fatigue
/wiki/red-vs-blue	Red vs. Blue
/wiki/lego-universe	Lego Universe
/wiki/security-certificates	Security Certificates
/wiki/cafe-world	Cafe World
/wiki/bullguard-internet-security-10	BullGuard Internet Security 10
/wiki/myedu	MyEdu
/wiki/sitejabber	SiteJabber
/wiki/online-gambling-addiction	Online Gambling Addiction
/wiki/iantivirus-mac-os-x	IAntiVirus for Mac OS X
/wiki/grindr	Grindr
/wiki/candeo	Candeo
/wiki/books-about-myspace	Books About MySpace
/wiki/facebook-security	Facebook Security
/wiki/pc	PC
/wiki/usb-port	USB Port
/wiki/punditkitchen	PunditKitchen
/wiki/amazoncom	Amazon.com
/wiki/remote-accessdesktop	Remote Access/Desktop
/wiki/cookie-clicker	Cookie Clicker
/wiki/safewave	Safewave
/wiki/mcafee-family-protection-android-edition	McAfee Family Protection Android Edition
/wiki/how-and-when-do-i-cite-sources	How and When Do I Cite Sources?
/wiki/how-disable-pop-ups-internet-explorer	How to disable pop ups in internet explorer
/wiki/cybercoyote	CyberCoyote
/wiki/bliptv	Blip.tv
/wiki/ncpgamblingorg	Ncpgambling.org
/wiki/nyan-cat	Nyan Cat
/wiki/safebooru	Safebooru
/wiki/torrent	torrent
/wiki/chatting-and-messaging	Chatting and Messaging
/wiki/blogs-organizations	Blogs for Organizations
/wiki/ant-smasher	Ant Smasher 
/wiki/facebook-vs-myspace-which-ones-safer	Facebook vs. Myspace: Which one's Safer?
/wiki/yodio	Yodio
/wiki/block-explicit-websites-computer	Block Explicit Websites from Computer 
/wiki/gaiaonline	GaiaOnline
/wiki/mark-zuckerberg	Mark Zuckerberg
/wiki/internet-safety-awards	Internet Safety Awards
/wiki/ancestrycom	Ancestry.com
/wiki/fair-use	Fair Use
/wiki/william-francis-melchert-dinkel	William Francis Melchert-Dinkel
/wiki/asmallworld	ASmallWorld
/wiki/ugly-bug-ball	The Ugly Bug Ball
/wiki/dansguardian	DansGuardian
/wiki/totally-looks	Totally Looks Like
/wiki/how-put-quietube-your-computer	How to Put Quietube on Your Computer
/wiki/how-check-cookies-firefox	How to Check Cookies in Firefox
/wiki/adultweblawcom	Adultweblaw.com
/wiki/travellerspoint	Travellerspoint
/wiki/fbigov	FBI.gov
/wiki/create-consumer-demand-profit-later	Create Consumer Demand, Profit Later
/wiki/delicious	Delicious
/wiki/mmo-glossary	MMO Glossary
/wiki/dangers-using-admin-account	Dangers in using the Admin Account
/wiki/google-play-store	Google Play Store
/wiki/nienie-dialogues	NieNie Dialogues
/wiki/gilt-groupe	Gilt Groupe
/wiki/googles-internet-safety-tips	Google's Internet Safety Tips
/wiki/gamepro	GamePro
/wiki/scams	Scams
/wiki/friendster	Friendster
/wiki/mcafee-crash	McAfee Crash
/wiki/pharming	Pharming
/wiki/4kids	4Kids
/wiki/antichildpornorg	AntiChildPorn.org
/wiki/time-warner	Time Warner
/wiki/public-computers	Public Computers
/wiki/spoofing	Spoofing
/wiki/webers-grill	Weber's On the Grill
/wiki/drug-new-millennium-brain-science-behind-internet-pornography-use	The Drug of the New Millennium: The Brain Science Behind Internet Pornography Use
/wiki/videojugcom	Videojug.com
/wiki/american-academy-pediatrics	American Academy of Pediatrics
/wiki/geinimi-trojan	Geinimi Trojan
/wiki/barney-and-friends	Barney and Friends
/wiki/klaaskids-foundation	KlaasKids Foundation
/wiki/ezinearticles	EzineArticles
/wiki/flash-animations	Flash Animations
/wiki/cyberbullying-research-center	Cyberbullying Research Center
/wiki/proxy-server	proxy server
/wiki/accidental-billionaires	Accidental Billionaires
/wiki/user-authentication-so-easy-child-could-do-it	User authentication: so easy, a child could do it.
/wiki/bitdefender-antivirus-pro-2011	BitDefender Antivirus Pro 2011
/wiki/books-written-teens	Books Written for Teens
/wiki/fake-site-scams	Fake site scams
/wiki/mature-video-games	Mature Video Games
/wiki/parental-controls-mac-os-x-105	Parental Controls in Mac OS X 10.5
/wiki/parental-controls-mac-os-x-106	Parental Controls in Mac OS X 10.6
/wiki/books-about-pornography	Books About Pornography
/wiki/parental-controls-mac-os-x-108	Parental Controls in Mac OS X 10.8
/wiki/google-drive	Google Drive
/wiki/avg-anti-virus-free-edition	AVG Anti-Virus Free Edition
/wiki/coffeecup	CoffeeCup
/wiki/audacity	Audacity
/wiki/esafekids	ESafeKids
/wiki/harvard-sailing-team	The Harvard Sailing Team
/wiki/age-conan	Age of Conan
/wiki/dragon-tales	Dragon Tales
/wiki/numa-numa	Numa Numa
/wiki/how-remotely-connect-others%E2%80%99-computer-using-team-viewer	How to remotely connect to others’ computer using team viewer.
/wiki/mychild	MyChild
/wiki/random-website-dot-com	Random Website Dot Com
/wiki/norton-safe-web	Norton Safe Web
/wiki/pornoculationcom	Pornoculation.com
/wiki/texts-last-night	Texts From Last Night
/wiki/plenty-fish	Plenty of Fish
/wiki/microtransactions	Microtransactions
/wiki/android-parental-controls	Android Parental Controls
/wiki/antivirus-software	Antivirus Software
/wiki/bill-gates	Bill Gates
/wiki/movie-review-sites	Movie review sites
/wiki/mumble	Mumble
/wiki/wikitubia	Wikitubia
/wiki/star-wars-uncut	Star Wars Uncut
/wiki/incognito-web-browsing-browse-private	Incognito Web Browsing (browse in private)
/wiki/i-os5	i OS5
/wiki/david-after-dentist	David After Dentist
/wiki/gnu	GNU
/wiki/battlefield-series	The Battlefield Series
/wiki/anti-pornography-organizations	Anti-Pornography Organizations
/wiki/symantec	Symantec
/wiki/cyberbullying	Cyberbullying
/wiki/otaku	Otaku
/wiki/national-center-missing-and-exploited-children	National Center for Missing and Exploited Children
/wiki/vocaroo	Vocaroo
/wiki/pet-society	Pet Society
/wiki/kloutcom	Klout.com
/wiki/dota2	Dota2
/wiki/internet-safety-project-style-guide	The Internet Safety Project Style Guide
/wiki/mcafee-total-protection	McAfee Total Protection
/wiki/anti-spam-software	Anti-Spam Software
/wiki/internetsafetyeducator	InternetSafetyEducator
/wiki/icarly	ICarly
/wiki/how-download-safari	How to Download Safari
/wiki/study-scholar-scholar	Study Like a Scholar, Scholar
/wiki/other-organizations	Other Organizations
/wiki/facebook-stalking	Facebook Stalking
/wiki/iboss	iboss
/wiki/how-it-should-have-ended	How It Should Have Ended
/wiki/lavasoft-ad-aware	Lavasoft Ad-Aware
/wiki/piggybacking	Piggybacking
/wiki/how-examine-security-certificates-google-chrome	How to Examine Security Certificates in Google Chrome
/wiki/blocking-javascript-firefox-noscript	Blocking Javascript in FireFox with NoScript
/wiki/private-browsing	Private browsing
/wiki/goodreads	Goodreads
/wiki/romantically-apocalyptic	Romantically Apocalyptic
/wiki/livemocha	LiveMocha
/wiki/usenet	Usenet
/wiki/pictures-sad-children	Pictures For Sad Children
/wiki/ratemyteachers	RateMyTeachers
/wiki/midomi	Midomi
/wiki/sesame-street	Sesame Street
/wiki/national-coalition-against-domestic-violence	National Coalition Against Domestic Violence
/wiki/my-moment	My Moment
/wiki/amazon-controversies	Amazon Controversies
/wiki/sandbox	Sandbox
/wiki/hautelook	HauteLook
/wiki/professor-garfield-foundation	Professor Garfield Foundation
/wiki/googles-family-safety-center	Google's Family Safety Center
/wiki/fact-monster	Fact Monster
/wiki/spam-terrier	Spam Terrier
/wiki/its-over-9000	It's Over 9000!
/wiki/bitdefender-free-edition	BitDefender Free Edition
/wiki/spybot-search-destroy	Spybot - Search & Destroy
/wiki/stop-third-parties-and-search-engines-tracking-you-chrome-web-browser	Stop third parties and search engines from tracking you in the Chrome web browser.
/wiki/eset	ESET
/wiki/do-not-track	Do Not Track
/wiki/myheritagecom	MyHeritage.com
/wiki/usb-drive	USB Drive
/wiki/curious-george	Curious George
/wiki/scribd	Scribd
/wiki/netiquette	Netiquette
/wiki/eeggs	Eeggs
/wiki/hey-tell	Hey Tell
/wiki/jimmy-surprises-bieber-fan	Jimmy Surprises Bieber Fan
/wiki/superherohypecom	SuperHeroHype.com
/wiki/mcafee-family-protection-mac	McAfee Family Protection for Mac
/wiki/internet-filtering	Internet Filtering
/wiki/browser-games	Browser Games
/wiki/sprint	Sprint
/wiki/jeremy-jahn	Jeremy Jahn
/wiki/scishow	SciShow
/wiki/how-download-chrome	How to Download Chrome
/wiki/family-online-safety-institute	Family Online Safety Institute
/wiki/google-ads	Google Ads
/wiki/rdio-music	Rdio Music
/wiki/how-prevent-identity-theft	How to Prevent Identity Theft
/wiki/bizrate	BizRate
/wiki/copyright-internet-content	Copyright on Internet content
/wiki/norton-internet-security-dual-protection-mac	Norton Internet Security Dual Protection for Mac
/wiki/battlenet-parental-controls	Battle.net Parental Controls
/wiki/google	Google +
/wiki/how-create-skype-account	How to Create a Skype Account
/wiki/kids-mind	Kids-in-Mind
/wiki/national-criminal-justic-reference-center	National Criminal Justic Reference Center
/wiki/comcast	Comcast
/wiki/banner-ads	Banner Ads
/wiki/polly-klaas-foundation	Polly Klaas Foundation
/wiki/intonow	IntoNow
/wiki/muxlim	Muxlim
/wiki/internet-safety-foundation-colorado	Internet Safety Foundation Colorado
/wiki/internet-protocol-address-ip-address	Internet Protocol Address (IP Address)
/wiki/funsitescom	Funsites.com
/wiki/gaming	Gaming
/wiki/parry-aftab	Parry Aftab
/wiki/macrium-reflect	Macrium Reflect
/wiki/online-discussion-boards	Online Discussion Boards
/wiki/kahn-academy	Kahn Academy
/wiki/how-link-articles-within-wiki	How to link to articles within the Wiki
/wiki/cone-ing	Cone-ing
/wiki/should-your-child-have-ipod-touch	Should Your Child Have an iPod Touch?
/wiki/keepass	Keepass
/wiki/stopbullyinggov	Stopbullying.gov
/wiki/software-businesses	Software for Businesses
/wiki/tastebuds	Tastebuds
/wiki/fan	Fan
/wiki/anonymous	Anonymous
/wiki/rhapsody	Rhapsody
/wiki/mypasswordmanager	MyPasswordManager
/wiki/doodle-jump	Doodle Jump
/wiki/gamefly	GameFly
/wiki/diigo	Diigo
/wiki/ars-technica	Ars Technica
/wiki/bitdefender-total-security-2011	BitDefender Total Security 2011
/wiki/child-id	Child ID
/wiki/netsafe-utah	NetSafe Utah
/wiki/cyber-top-cops	Cyber Top Cops
/wiki/peer-peer-file-sharing	Peer-to-Peer File Sharing
/wiki/snopes	Snopes
/wiki/lds-media-talk	LDS Media Talk
/wiki/firewalls	Firewalls
/wiki/trolls	Trolls
/wiki/aqcom	aq.com
/wiki/cookies	Cookies
/wiki/password	Password
/wiki/avast-pro-antivirus	Avast! Pro Antivirus
/wiki/accountable2you	Accountable2You
/wiki/chat-rooms	Chat Rooms
/wiki/hotornotcom	HotOrNot.com
/wiki/lonelygirl15	Lonelygirl15
/wiki/flipline	Flipline
/wiki/little-snitch	Little Snitch
/wiki/4chan	4chan
/wiki/blippy	Blippy
/wiki/gamefront-previously-filefront	GameFront (previously FileFront)
/wiki/guild-wars-2	Guild Wars 2
/wiki/mousemail	Mousemail
/wiki/music-and-audio-content-sharing	Music and Audio Content Sharing
/wiki/mysterious-ticking-noise	Mysterious Ticking Noise
/wiki/emsisoft-internet-security-pack	Emsisoft Internet Security Pack
/wiki/spinthebottlecom	spinthebottle.com
/wiki/how-configure-built-firewall-ubuntu	How to configure the built-in firewall in Ubuntu
/wiki/creative-commons	Creative Commons
/wiki/pinterest	Pinterest
/wiki/bitdefender-antivirus-mac	BitDefender Antivirus for Mac
/wiki/how-block-flash-google-chrome	How to Block Flash in Google Chrome
/wiki/file-extensions	File Extensions
/wiki/god-war-3-game-guide	God of War 3 Game Guide
/wiki/ios-content-filter-browsers	iOS Content Filter Browsers
/wiki/xing	Xing
/wiki/wot-web-trust	WOT: Web of Trust
/wiki/tweets	Tweets
/wiki/internet-education-foundation	Internet Education Foundation
/wiki/socialnomics	Socialnomics
/wiki/failbook	Failbook
/wiki/know-your-meme	Know Your Meme
/wiki/pok%C3%A9mon-global-link	Pokémon Global Link
/wiki/make-pact	Make a PACT
/wiki/bully-police-usa	Bully Police USA
/wiki/old-spice-guy	Old Spice Guy
/wiki/tracking-image	Tracking image
/wiki/keepassdroid-android-app	KeePassDroid Android App
/wiki/let-me-google-you	Let Me Google That For You
/wiki/imvu	IMVU
/wiki/comodo-antivirus	Comodo Antivirus
/wiki/ebay	EBay
/wiki/anonymous-hacking-group	Anonymous hacking group
/wiki/windows	Windows
/wiki/norton-antivirus	Norton AntiVirus
/wiki/how-disable-javascript-opera	How to Disable JavaScript in Opera
/wiki/oculus-rift	Oculus Rift
/wiki/fring	Fring
/wiki/illegal-online-music-websites	Illegal Online Music Websites
/wiki/i-am-worlds-most-interesting-intern	I Am the World's Most Interesting Intern
/wiki/interactive-us-history-map	Interactive US History Map
/wiki/covenant-eyes	Covenant Eyes
/wiki/pro-musicorg	Pro-music.org
/wiki/jaroo	Jaroo
/wiki/emsisoft	Emsisoft
/wiki/how-enable-do-not-track-option-chrome	How to enable "Do Not Track" option in Chrome
/wiki/animal-crossing	Animal Crossing
/wiki/webroot	Webroot
/wiki/lg-text-ed	LG Text Ed
/wiki/funnyjunk	Funnyjunk
/wiki/godaddycom	GoDaddy.com
/wiki/social-bookmarking	Social Bookmarking
/wiki/kindle	Kindle
/wiki/american-library-association	American Library Association
/wiki/shareware	Shareware
/wiki/microsoft	Microsoft
/wiki/ebooks	EBooks
/wiki/domain-names	Domain Names
/wiki/minecraft-modding	Minecraft: Modding
/wiki/ryan-higa	Ryan Higa
/wiki/planking	Planking
/wiki/how-access-browsing-history-firefox	How to Access Browsing History in Firefox
/wiki/jk-wedding-dance	JK Wedding Dance
/wiki/urlesque	Urlesque
/wiki/american-foundation-suicide-prevention	American Foundation for Suicide Prevention
/wiki/skimming	Skimming
/wiki/netmomcom	Netmom.com
/wiki/insafe	Insafe
/wiki/gamefaqs	GameFAQs
/wiki/petlip	PetLip
/wiki/main-page	Main Page
/wiki/memebasecom-internet-meme-site	Memebase.com - Internet Meme Site
/wiki/ninjadoodle	Ninjadoodle
/wiki/jailbreaking-iphone	Jailbreaking iPhone
/wiki/level-treadmill	Level Treadmill
/wiki/microblogging	Microblogging
/wiki/tips-writing-good-wiki-article	Tips for Writing a Good Wiki Article
/wiki/listverse	Listverse
/wiki/whatswhatme	Whatswhat.me
/wiki/spamlawscom-brief-review	SpamLaws.com: A Brief Review
/wiki/mmguardian-parental-control	MMGuardian Parental Control
/wiki/plug	Plug-In
/wiki/trojan-horses	Trojan Horses
/wiki/repetitive-stress-injury	Repetitive Stress Injury
/wiki/buzznet	Buzznet
/wiki/mylife	MyLife
/wiki/troll	troll
/wiki/how-can-i-protect-my-computer-being-infected-virus	How Can I Protect My Computer From Being Infected By a Virus?
/wiki/alexa	Alexa
/wiki/figmentcom	figment.com
/wiki/woophy	Woophy
/wiki/mobile-devices	Mobile Devices
/wiki/techshout	TechShout
/wiki/blacklist	Blacklist
/wiki/safechildorg	Safechild.org
/wiki/orkut	Orkut
/wiki/freddiew	freddiew
/wiki/e-reader	E-reader
/wiki/giant-hello	Giant Hello
/wiki/how-set-opendns-familyshield-router-preferred	How to set up OpenDNS FamilyShield with a Router (Preferred)
/wiki/mcafee-antivirus-plus	McAfee AntiVirus Plus
/wiki/online-magazine	Online Magazine
/wiki/limewire	LimeWire
/wiki/zynga	Zynga
/wiki/youve-won-scams	"You've Won..." Scams
/wiki/outpost-antivirus-pro	Outpost Antivirus PRO
/wiki/companies-and-products	Companies and Products
/wiki/lg-dtxtr	LG Dtxtr
/wiki/chatdangercom	Chatdanger.com
/wiki/carnegie-library-pittsburgh	Carnegie Library of Pittsburgh
/wiki/imgur	Imgur
/wiki/digital-death	Digital Death
/wiki/marvel	Marvel
/wiki/dolphin-secure	Dolphin Secure
/wiki/bnetsavvy	BNetSavvy
/wiki/webkinz	Webkinz
/wiki/safety-clicks	Safety Clicks
/wiki/ideeli	Ideeli
/wiki/wiredcom	wired.com
/wiki/lifelock	LifeLock
/wiki/whitelisting	Whitelisting
/wiki/flock	Flock
/wiki/sony-play-station-portable-psp	Sony Play Station Portable (PSP)
/wiki/loopt	Loopt
/wiki/unfriending	Unfriending
/wiki/coffee	COFFEE
/wiki/wallet-windows-phone	Wallet (Windows Phone)
/wiki/star-wars-kid	Star Wars Kid
/wiki/virtual-currency	Virtual currency
/wiki/kidsbesafeonlinecom	KidsBeSafeOnline.com
/wiki/lamebook	Lamebook
/wiki/defending-our-kids-julie-posey-story	Defending Our Kids: The Julie Posey Story
/wiki/linkedin	LinkedIn
/wiki/hubpages	HubPages
/wiki/msn	MSN
/wiki/spore2d	Spore2d
/wiki/rfid	RFID
/wiki/cheatcccom	Cheatcc.com
/wiki/mp3tunes	MP3tunes
/wiki/rooms	In The Rooms
/wiki/tiger-mom	Tiger Mom
/wiki/leet-speak	Leet Speak
/wiki/mcgrufforg	McGruff.org
/wiki/download-online-videos	Download Online Videos
/wiki/camstudio	CAMSTUDIO
/wiki/imview	ImView
/wiki/lds-family-services	LDS Family Services
/wiki/face-recognition	Face Recognition
/wiki/internet-dating	Internet Dating
/wiki/peta	PETA
/wiki/online-movies	Online Movies
/wiki/pan-european-game-information	Pan European Game Information
/wiki/tapulous	Tapulous
/wiki/amazon-mechanical-turk	Amazon Mechanical Turk
/wiki/battlenet	Battle.net
/wiki/emsisoft-emergency-kit-free	Emsisoft Emergency Kit Free
/wiki/keystroke-loggers	Keystroke loggers
/wiki/overpayment-scams	Overpayment Scams
/wiki/internet-solutions-kids-inc	Internet Solutions For Kids, Inc
/wiki/federal-trade-commission	Federal Trade Commission
/wiki/online-armor-firewall	Online Armor Firewall
/wiki/how-delete-your-facebook-account	How to Delete Your Facebook Account
/wiki/ratemyprofessorscom	RateMyProfessors.com
/wiki/craigslist-killer-movie	Craigslist Killer Movie
/wiki/parental-controls	Parental Controls
/wiki/sextortion	Sextortion
/wiki/2-spywarecom	2-spyware.com
/wiki/kidswatch	KidsWatch
/wiki/lord-rings-online	Lord of the Rings Online
/wiki/zilladog	Zilladog
/wiki/pure-sight	Pure Sight
/wiki/how-add-tags	How to Add Tags
/wiki/norton-360	Norton 360
/wiki/besafeonlineorg	besafeonline.org
/wiki/lady-gaga	Lady Gaga
/wiki/isnare	ISnare
/wiki/tinder	Tinder
/wiki/internet-safety-day	Internet Safety Day
/wiki/how-use-guided-access-ios-6	How To Use Guided Access in iOS 6
/wiki/sinacom	Sina.com
/wiki/using-lastpass-security	Using LastPass for security
/wiki/tls	Tls
/wiki/zonealarm	ZoneAlarm
/wiki/cyberethics-kids	Cyberethics for Kids
/wiki/open-office	Open Office
/wiki/rottentomatoes	Rottentomatoes
/wiki/aarp	AARP
/wiki/internet-and-your-child	The Internet and Your Child
/wiki/terraria	Terraria
/wiki/saturday-night-live-viral-videos	Saturday Night Live Viral Videos
/wiki/adblock-blocking-unwanted-advertisements-google-chrome	AdBlock - Blocking Unwanted Advertisements in Google Chrome
/wiki/ad-council-internet-safety-coalition	Ad Council Internet Safety Coalition
/wiki/how-protect-tweets-twitter	How to Protect Tweets on Twitter
/wiki/how-add-images-articles	How to Add Images to Articles
/wiki/how-configure-built-firewall-mac-osx-leopard-and	How to configure the built-in firewall in Mac OSX (Leopard and up)
/wiki/toolbar	Toolbar
/wiki/ncjrsgov	NCJRS.gov
/wiki/system-updates	System Updates
/wiki/mylifeistwilight	MyLifeIsTwilight
/wiki/gateway	Gateway
/wiki/procon-latte	ProCon Latte
